%%%%%%%%
%      %
%P.% . %
% .% . %
%    G %
%%%%%%%%