%%%%%%
%P   %
% %% %
% %. %
% %% %
%. G %
%%%%%%